*************************
*                       *
*                       *
* p                     *
*                       *
*                0      *
*                       *
*************************