****************       ***********
*   *******   **       *         *
* p           **       *         *
*   *******   **       *         *
*****     *   **       *         *
          *   **       *         *
          *   **       *  ********
          *   **       *  *
          *   **       *  *
***********   **       *  *
*             **********  *
*       0                 *
*             *************
*             **
*             **
****************
